-------------------------o?---X---B-X-------o------------B-X-X----------B-------B---?--?-X--------BB------B----B-------------------?--o---------------------------?-B------------?-------------M---X--M----
---M----B---------------------------M---------------M------------?------------------------X--X?----------------o-M---?X-----B----M------B------B------X--X-B-----X-------o-------?--B-----B----------------
--B--------------X-X--------BM--B----------B--M-------o-B----------o-XB--B-------o----B-----?----------M---?-------------X---X---------------X-----------------M----------------------------o-----?--------
---------------?-------------------X----B-------o-B-------------?------o------X----------X------X--XB-----?-------------------X-X---------o------------------M-----?M-------------B-----------?-B----X-----
-?--X-------------M------o----o---------------------M------o---B------------o--------o--------M---------M---o-B---------o--------M----o--------------------o----M-------------?-----o----------------------
-------o-----------------------------?-----o-----X----------------------M----B--X------------------------X---B------o-X--------------------X----B---X----------M------?---------o----------o-X------B------
--X---?-?-----X--------o--B---------------X-M--M-------------M------------------------oB?------o------M----------M---------M-------------o?----------B---------------M---------X----------M----?-----------
---------------------------?-----B-------o---------X-------------M---X----BM-------------------------M------------?------------B--------M-------------?------------------------------------------------v---
-B---X-------------------B-----X------X--------------B---M---------------------?-o--?-------------M--------------------X--X------------M-----------B?-----------M---X-M-M---M------------X----------B-of---
----B-----------------o-?------------------?-----------o------o-----?-o-o-----B-------BX----B------------?---M---------------oo----------------B--------------M----o-----?----XX---BXX--X-o--------?---f---
---X----MB-------------?-----------X-----X---X---B--------M-Bo-o---X---o-----------------X---M-X------------------?-?-B--------------------------B---?---------------------B-B-------------------------f---
------Xo---B-----??--B--------o-----?--------------------------------------------?--------?M-------B---M----?----B-B------o--------------M----?----X--?--------B-----------------------M---------------f---
----X--------------M------------------o-B--X------X---------------------------------M-----------------?--?X---X----------B----------B--------------------?--------X----X?-M-----?-----M--?----B-------Bf---
--T-----------TB----------T-o----------B--X---o-----o---o--X-B---B------B-----TB-----T--B-----X-------------------X---TT?---?B--?-B-------MM------?--------------B-BX-------------X--?--X----?-o--TX---f---
m-|----------o|---T----Eo-|o---------E-----------o----------E---E-T--------o--|--T---|-o--E--------------------T-----T||------E--E-----------o---E------------o---------------E-----o-----E-------|-o--X---
XX|XX-----XXX-|-XX|XXXXXXX|--XX------XX---X-----XX-X-XX-X---XXXXX-|---XX-X-X-X|--|XX-|XXXXXXXXX-X-XXX-XX-X--X--|-X-XX|||XXX-XXXXXXXTX--X-XXX---XXXX-XX--XXXX-X-X-X-X-X-XXX---XXX-XXXXX--X-X-XX-X-X|-XXXX---
